10.ox
...oooo...
o.ooo.o.oo
.ooooooooo
oo.o.o.o.o
o.oooo.ooo
o...ooo.o.
..oo.o..oo
oo....ooo.
oo.oo..o.o
ooo..o.o..
